NO textures/stone_wall.xpm
SO textures/stone_wall.xpm

EA textures/stone_wall.xpm


C 255,195,0
F 0,8,20

WE textures/stone_wall.xpm

            1111111      
  11111111111  1  1      
  1    1          11     
  1   W      0     1     
  1          1    11     
  1  11111   111111      
  11 1   11  1           
  1  1   1   1           
  1  1   1   1           
  1  1   111 11          
  1  1     1  11111      
  1  111   1  1   1      
  11   1   1      1      
   1   1   11    11      
   1   1    111   1      
   1   1      1   1      
   1   1       11111     
   11111                 
