NO textures/stone_wall.xpm
EA textures/stone_wall.xpm
WE textures/stone_wall.xpm
SO textures/stone_wall.xpm

C 255,229,220
F 216,226,220

       1111111111111111111111
111111111000000111100000011111
00000111110000001100000011111
111110000000000000000111111111
111111111000000110000000000111
111100000000000000000000111111111
111111000000111100000011110000001
111111000000111100000000000111111
1111E0000011000000000111111
111100000011000000111111
1111111111111111111111111111111