NO textures/north.xpm
EA textures/east.xpm
WE textures/west.xpm
SO textures/south.xpm

C 83,114,187
F 159,220,22

  111111111    111       
  1110000001111001111    
   100000 00100000001    
   100000000100000001    
   100000 0110   1101    
   11000 00000   10001   
    1000 000  111100011  
    1100   1N 100000001  
     110  11110000000011 
      10  11001000000001 
      100 11000010000001 
      100110000110000001 
     110010000110000001  
     100110001100000001  
     100100001110000001  
    1100000011110000001  
   10000110001110001111  
  110000111100000001     
  100000000000000001     
  110000000000000011     
   1111111110000011      
           111011        
              1          
