NO textures/stone_wall.xpm
EA textures/stone_wall.xpm
WE textures/stone_wall.xpm
SO textures/stone_wall.xpm

C 102,178,255
F 153,76,0

       1111111111111111111111
111111111     1111        11111
   11111     11           11111
11111                 111111111
111111111       11          111
1111                  111111111
111111      1111         1111 1
111111      1111         111111
1111              11     111111
1111        11           111111
1111111111111111111111111111111