NO textures/cyberwickN.xpm
EA textures/cyberwickE.xpm
WE textures/cyberwickW.xpm
SO textures/cyberwickS.xpm

C 83,114,187
F 159,220,22

          11111111111111111111111
          10000010000010000000001
          10000000111110000100001
          11110000000010000100001
          10000000000010000100001
111111111111111111100000111111111
100000000000100000000000000000001
00000000000010000000000000000000011
1111111111001000000 0000N00000001
         0110000000000000000000001
11111111110000010000001111110000001
10000000100000010000000000010000001
10000000000000010000000000010000001
11111111111111111111111111101111111