NO textures/jkk1.xpm
EA textures/jkk2.xpm
WE textures/jkk3.xpm
SO textures/jkk4.xpm

C 174,198,210
F 255,131,214

1111111111111111111111111
10000010000010000000001
10000000000010000000001
10000000000010000000001
10000000000010000000001
111111111111111111111111111111111
100000000000100000000000000000001
00000000000010000000000000000000011
      11 0110000000000000000000001
1111110011000001000000   10000001
100000001000000000N0000000010000011
10000000000000010000000000010000001
11111111111111111111111111101111111