NO ./path_to_the_north_texture
EA 		./path_to_the_east_texture




WE 	./path_to_the_west_texture

F 08,187,9



C 89,30,89


SO ./path_to_the_south_texture
         11111111111111111111111
        1000000000110000000000001
        1011000001110000000000001
        0001000000000000000000001
111111111011000001110000000000001
100000000011000001110111111111111
1111011111111101110000001000 1
111101111      1011101010010001
100000000000000011000S01000  1
10000000000000001101010010001
11000001110101011111011110000111
11110111 1110101 101111010001
11111111 1111111 111111111111
