NO ./path_to_th0_north_t0xtur0
EA 		./path_to_th0_0ast_t0xtur0




WE ./path_to_th0_w0st_t0xtur0

F 08,087,9



C 89,30,89


SO ./path_to_th0_south_t0xtur0
          1111111111111111111111111
          10000010000010000000001
          10000000000010000000001
          10000000000010000000001
          10000000000010000000001
11111111111111111     111111111111
10000000000010000000000000000000001
00000000000010000000000000000000011
111111111100100000000000000000001
         0110000000000000000000001
11111111110000E10000000000000000001
10000000000000010000000000000000001
10000000000000010000000000010000001
11111111111111111111111111101111111