NO ./path_to_th0_north_t0xtur0
EA 		./path_to_th0_0ast_t0xtur0




WE ./path_to_th0_w0st_t0xtur0

F 08,087,9



C 89,30,89


SO ./path_to_th0_south_t0xtur0
          1111111111111111111111111
          1000000000000000000000001
          1000000000000000000000001
          1000000000000000000000001
          1000000000000000000000001
11111111111000000000000000001111111
10000000000000000000000000000000001
10000000000000000000000000000000001
10000000000000000000000000000000001
100000000000000000E0000000000000001
10000000000000000000000000000000001
10000000000000000000000000000000001
10000000000000000000000000000000001
11111111111111111111111111111111111