EA textures/bts2.xpm
WE textures/bts3.xpm
SO textures/bts4.xpm
NO textures/bts1.xpm

F 255,255,255

    111111111 00         
   11 00000010000        
   1 00 0 00100 0        
   1    0 01100 0        
   1 0 00011000 0        
   1 0 00011000000       
   1100 0N010000 0       
    100 00010000  0      
    10000010 000  0      
     10001 00000 0       
     1100100  0 00       
      11 10000 0         
       11100             

C 238,204,229