NO textures/north.xpm
EA textures/east.xpm
WE textures/west.xpm
SO textures/south.xpm

C 83,114,187
F 159,220,22

   1111                  
 111 0111                
 100 011111100           
 100 0   0  111          
1000 0   000  10         
100000  0 0    1         
1 000000000 00 1         
1000000000  00 1         
100111100 0000  1        
1001S0100   0  01        
1010000100 000  1        
1000000100  0  01        
1001110100  0 0 1        
100001010000 0 01        
1000100010  00 01        
100010001   0   1        
100011011  0    1        
10000110000     1        
100000000000    1        
10 0  000000    1        
11 0000 0       1        
 11    0    0001         
 0  1  00000  11         
00  1       1110         
000011111111100          