
NO textures/jjk1.xpm
SO textures/jjk2.xpm
WE textures/jjk3.xpm
EA textures/cyberwickN.xpm

F 184,113,39
C 51,198,227

        1111111111111111111111111
        1000000000110000000000000
        1011000001110000000000000
        1001000000000000000000001
111111111011000001110000000000001
100000000011000001111111111111111
11110111111111011100000010001
11110111111111010101010010001
11000000110101011100000010001
00000000000000001100000000001
00000000000000001101010010001
11000001110101011111011110N0111
11110111 1110101 101111010001
11111111 1111111 111111111111