
NO textures/jjk1.xpm
SO textures/jjk2.xpm
WE textures/jjk3.xpm
EA textures/cyberwickN.xpm

S  textures/.xpm

F 184,113,39
C 51,198,227

        111111111111111111111110
        1000000000110000000111011
        1011000001110000000110001
        100100000E000000000110001
111111111011000001110000000000001
100000000011000001110111111100111
11110111111111011100000010001
11110111111111011101010010001
11000000110101011100000010001
10000000000000001100000000001
10000000000000001101010010001
110000011101010111110111100111
11110111 1110101 101111010001
11111111 1111111 111111111111
