
NO textures/jjk1.xpm
SO textures/jjk2.xpm
WE textures/jjk3.xpm
EA textures/cyberwickN.xpm

F 184,113,39
C 51,198,227

1111111111111
1000000000001
100000N000001

1000000000001
1111111111111
