NO textures/bts1.xpm
EA textures/bts2.xpm
WE textures/bts3.xpm
SO textures/bts4.xpm

C 83,114,187
F 159,220,22

          1111111111111111111111111
          10000010000010000000001
          10000000000010000000001
          10000000000010000000001
          10000000000010000000001
11111111111111111     111111111111
10000000000010000000000000000000001
00000000000010000000000000000000011
1111111111001000000N0000000000001
         0110000000000000000000001
11111111110000010000000000000000001
10000000000000010000000000000000001
10000000000000010000000000010000001
11111111111111111111111111101111111