NO textures/jkk1.xpm
EA textures/jkk2.xpm
WE textures/jkk3.xpm
SO textures/jkk4.xpm

C 174,198,210
F 255,131,214

111111111111111111111111111111111111111
100000000000000000001000000000000000001
100000000000000000001000000000000000001
101100000000000111111000000000000000001
100N00000000000000001000000000000000001
100000100000000000001000000000000000001
100000100000111111111000000000000000001
100000111000000000001000000000000000001
100000100000000000000000000000000000001
111111111111111111111000000000000000001
100000000000000000000000000000000000001
100000000000000000000000000000000000001
100000000000000000000000000000000000001
100000000000000000000000000000000000001
100000000000000000000000000000000000001
100000000000000000000000000000000000001
100000000000000000000000000000000000001
100000000000000000000000000000000000001
111000000000000000000000000000000000001
100000000000000000000000000000000000001
100100000000000000000000000000000000001
111111111111111111111111111111111111111