NO textures/cyberwickN.xpm
EA textures/toji1.xpm
WE textures/cyberwickW.xpm
SO textures/toji2.xpm

C 255,216,190
F 147,129,255

        1111             
       101011            
       100001            
       110001            
       11001             
     11000001            
    1001000001           
    1000101001           
   10010001001
   11100001001           
   1000000101            
    1N010111             
     1010011             
      11111    