NO textures/johnny1.xpm
EA textures/rect_toji.xpm
WE textures/johnny_vertical.xpm
SO textures/toji3.xpm

C 153,204,255
F 255,255,153

        1111             
       101011            
       100001            
       110001            
       11001             
     11000001            
    1001000001           
    1000101001           
   10010001001           
   11100001001           
   1000000101            
    1E010111             
     1010011             
      11111    