NO textures/toto.xpm
EA textures/jojo.xpm
WE textures/toto.xpm
SO textures/jojo.xpm

C 83,114,187
F 159,220,22



11111111
10000001
10000001
100N0001
10000001
10000001
10000001
11111111